1 13 31
###############################
#p     x* *   1 *   # *   *   #
# # # #*# # #*#*# # # #*#*#*# #
#   f       *5 *      *   * * #
# # # # # #*# # #*# # # # # #*#
#f     *  *     4*  *  1      #
# # # # # # # # # # #1#*# # # #
#*  *      *  *      *        #
# # # # #*# # # #*# # # # # # #
#*    **  *           *       #
# #*# # # # # # #*# # # # # # #
#          4*   *  *          #
###############################