1 13 31
###############################
#p     x* *   1 *   # *   *   #
# # # #*# # #*#*# # # #*#*#*# #
#   f       *2 *      *   * * #
# # # # # #*# # #*# # # # # #*#
#f     *  *     3*  *  1      #
# # # # # # # # # # #1#*# # # #
#*  *      *  *      *        #
# # # # #*# # # #*# # # # # # #
#*    **  *     1     *       #
# #*# # # # # # #*# # # # # # #
#           *   *  *          #
###############################