2 13 31
###############################
#p      * *    *   *  * * *   #
# # # #f# # #*#*# # # #*#*#*# #
#   f     * *  *   5  *   * * #
# # # # # #*# # #*#*# # # # #*#
#*         1 *4  *  *  1      #
# # # # # # # # # #*#1#*# # # #
#*  *  2   *  *   3  *        #
# # # # #*# # # #*#*# # # # # #
#*    **  *       *           #
# #*# # # # # # #*# # # # # # #
#x         2   *   *          #
###############################