2 13 31
###############################
#p      * *    *   *  * * *   #
# # # #*# # #*#*# # # #*#*#*# #
#   f     ***  *      *   * * #
# # # # # #*# # #*#*# # # # #*#
#f         1 **2 *  *  1     1#
# # # # # # # # # #*#1#*# # # #
#*  *  2   *  *      *        #
# # # # #*# # # #*#*# # # # # #
#*    **  *       *           #
# #*# # # # # # #*# # # # # # #
#x          *1  *  *          #
###############################