2 13 31
###############################
#p     x* *    *   *  * * *   #
# # # #*# # #*#*# # # #*#*#*# #
#   f     ***  *      *   * * #
# # # # # #*# # #*#*# # # # #*#
#f         x **1 *  *  1     1#
# # # # # # # # # #*#1#*# # # #
#*  *      *  *      *        #
# # # # #*# # # #*#*# # # # # #
#*    **  *       *           #
# #*# # # # # # #*# # # # # # #
#           *1  *  *          #
###############################