1 13 31
###############################
#p     x* *   1 *   # *   *   #
# # # #*# # #*#*# # # #*#*#*# #
#   f       *  *      *   * * #
# # # # # #*# # #*# # # # # #*#
#f     *  *    1 *  *  1      #
# # # # # # # # # # #1#*# # # #
#*  *      *  *      *        #
# # # # #*# # # #*# # # # # # #
#*    **  *           *       #
# #*# # # # # # #*# # # # # # #
#          1*   *  *          #
###############################