2 13 31
###############################
#p      * *    *   *  * * *   #
# # # #*# # #*#*# # # #*#*#*# #
#   f     * *  *   5  *   * * #
# # # # # #*# # #*#*# # # # #*#
#f         1 *4  *  *  1      #
# # # # # # # # # #*#1#*# # # #
#*  *  2   *  *   3  *        #
# # # # #*# # # #*#*# # # # # #
#*    **  *       *           #
# #*# # # # # # #*# # # # # # #
#x         2   *   *          #
###############################